0P0 0P0 0P0 0P0 0P0 0a0 0b0 0a0 0b0 0X0 0X0 0X0 0X0 0X0 0X0 0P0 0P0 0P0 0P0 0P0
0P0 0P0 0P0 0P0 1a0 2i0 1b0 1i0 0c0 1d0 1e0 1b0 0a0 1f0 2i0 1i0 0P0 0P0 0P0 0P0
0P0 0P0 0P0 1b0 2i0 2d0 2d0 1c0 1a0 1c0 1a0 1b0 1a0 2d0 2a0 2b2 0a0 0P0 0P0 0P0
0P0 0P0 1f1 2d0 2e1 2e0 1i0 2b0 1b0 1a0 1i0 1c0 2e0 2d0 2d2 2f0 2e1 0A0 0P0 0P0
0P0 0e1 2i0 0f2 0P0 1b0 0P0 2i0 2b0 1i0 1f0 2d0 2a0 0P2 1B0 0P0 1b0 2f0 0a0 0P0
0P0 2c0 2b0 1i0 0P0 1B1 0P0 2b0 2a0 0P0 0P0 2b1 2a2 0P0 1B0 0P0 1c0 2d0 2e0 0P0
0P0 0P0 0C0 1I0 1F0 0D0 0C2 1b0 1B1 0A0 0C0 1I2 1I0 0F0 0E0 1D0 1C0 0A0 0P0 0P0
0P0 0P0 0P0 2v0 2i0 2v0 2v0 2m0 2M0 2g0 2s0 2R0 2e2 2r0 2Q0 2c0 2f0 0P0 0P0 0P0
0P0 0P0 0P0 0P0 2d0 2d0 2e0 2b0 2m0 2g0 2g0 2s0 2r0 2s0 2s0 2g0 0P0 0P0 0P0 0P0
0P0 0P0 0P0 0P0 0P0 0P0 0P0 0P0 0P0 0P0 0P0 0P0 0P0 0P0 0P0 0P0 0P0 0P0 0P0 0P0