0P0 0P0 0P0 0P0 0P0 0X0 0A0 0A0 0A0 0X0 0X0 0X0 0X0 0X0 0X0 0P0 0P0 0P0 0P0 0P0
0P0 0P0 0P0 0P0 1A0 2I0 1B0 1I0 0C0 1D0 1E0 1B0 0A0 1F0 2I0 1I0 0P0 0P0 0P0 0P0
0P0 0P0 0P0 1B0 2I0 2D0 2D0 1C0 1A0 1C0 1A0 1B0 1A0 2D0 2A0 2B0 0A0 0P0 0P0 0P0
0P0 0P0 1F0 2D0 2E0 2E0 1I0 2A0 1C0 1B0 1I0 1C0 2E0 2D0 2D0 2F0 2E0 0A1 0P0 0P0
0P0 0E0 2I0 0F0 0P0 1B1 0P0 2A0 2B2 1I0 1F0 2D0 2A0 0P0 1B1 0P0 1B0 2F0 0A0 0P0
0P0 2C0 2B0 1I0 0P0 1B1 0P0 2B0 2A1 0P0 0P0 2B0 2A0 0P0 1B1 0P0 1C0 2D0 2E0 0P0
0P0 0P0 0C1 1I1 1F1 0D1 0C1 1A1 1B2 0A1 0C1 1I1 1I1 0F1 0E1 1D1 1C1 0A1 0P0 0P0
0P0 0P0 0P0 2X0 2X0 2X0 2X0 2X0 2X0 2X0 2X0 2X0 2X0 2X0 2X0 2X0 2X0 0P0 0P0 0P0
0P0 0P0 0P0 0P0 2X0 2X0 2X0 2X0 2X0 2X0 2X0 2X0 2X0 2X0 2X0 2X0 0P0 0P0 0P0 0P0
0P0 0P0 0P0 0P0 0P0 0P0 0P0 0P0 0P0 0P0 0P0 0P0 0P0 0P0 0P0 0P0 0P0 0P0 0P0 0P0