0P0 0P0 0P0 0P0 0P0 0X0 0a0 0a0 0a0 0X0 0X0 0X0 0X0 0X0 0X0 0P0 0P0 0P0 0P0 0P0
0P0 0P0 0P0 0P0 1x0 2x0 1x0 1x0 0x0 1x0 1x0 1b0 0a0 1f0 2i0 1i0 0P0 0P0 0P0 0P0
0P0 0P0 0P0 1x0 2x0 2x0 2x0 1x0 1x0 1x0 1x0 1b0 1x0 2x0 2x0 2x2 0x0 0P0 0P0 0P0
0P0 0P0 1x1 2x0 2x1 2x0 1x0 2x0 1x0 1b0 1i0 1c0 2e0 2d0 2d2 2f0 2e1 0A0 0P0 0P0
0P0 0e1 2i0 0x2 0P0 1b0 0P0 2a0 2b0 1c0 1f0 2d0 2a0 0P2 1B0 0P0 1x0 2x0 0a0 0P0
0P0 2x0 2x0 1x0 0P0 1x0 0P0 2x0 2x0 0P0 0P0 2x0 2x2 0P0 1x0 0P0 1x0 2x0 2e0 0P0
0P0 0P0 0x0 1x0 1x0 0x0 0x2 1X0 1c0 0x0 0c0 1x2 1x0 0x0 0x0 1x0 1x0 0x0 0P0 0P0
0P0 0P0 0P0 2x1 2x1 2c1 2x1 2c1 2x0 2x0 2x0 2R0 2e2 2O0 2Q0 2x0 2x0 0P0 0P0 0P0
0P0 0P0 0P0 0P0 2x0 2x0 2c2 2b0 2x1 2g2 2X0 2X0 2X0 2X0 2X0 2S0 0P0 0P0 0P0 0P0
0P0 0P0 0P0 0P0 0P0 0P0 0P0 0P0 0P0 0P0 0P0 0P0 0P0 0P0 0P0 0P0 0P0 0P0 0P0 0P0