0P 0P 0P 0P 0P 0X 0a 0a 0a 0X 0X 0X 0X 0X 0X 0P 0P 0P 0P 0P
0P 0P 0P 0P 1a 2i 1b 1i 0c 1d 1e 1b 0a 1f 2i 1i 0P 0P 0P 0P
0P 0P 0P 1b 2i 2d 2d 1c 1a 1c 1a 1b 1a 2d 2a 2b 0a 0P 0P 0P
0P 0P 1f 2d 2e 2e 1i 2a 1c 1b 1i 1c 2e 2d 2d 2f 2e 0A 0P 0P
0P 0e 2i 0f 0P 1B 0P 2a 2b 1i 1f 2d 2a 0P 1B 0P 1b 2f 0a 0P
0P 2c 2b 1i 0P 1B 0P 2b 2a 0P 0P 2b 2a 0P 1B 0P 1c 2d 2e 0P
0P 0P 0C 1I 1F 0D 0C 1A 1B 0A 0C 1I 1I 0F 0E 1D 1C 0A 0P 0P
0P 0P 0P 2X 2X 2v 2v 2m 2M 2g 2s 2R 2X 2O 2Q 2X 2X 0P 0P 0P
0P 0P 0P 0P 2X 2X 2X 2X 2X 2X 2X 2X 2X 2X 2X 2S 0P 0P 0P 0P
0P 0P 0P 0P 0P 0P 0P 0P 0P 0P 0P 0P 0P 0P 0P 0P 0P 0P 0P 0P